WE ./textures/north_texture.xpm
SO ./textures/south_texture.xpm
NO ./textures/west_texture.xpm
EA ./textures/east_texture.xpm

F 220,100,0
C 225,30,0
         1
       1101
   1111000011
   1110000N001
   10001111111111111 111111
   1111
